NO /home/emkalkan/42/Cub3D-main/textures/Brick256.xpm
SO /home/emkalkan/42/Cub3D-main/textures/Brick256.xpm
WE /home/emkalkan/42/Cub3D-main/textures/Brick256.xpm
EA /home/emkalkan/42/Cub3D-main/textures/Brick256.xpm

F 100,0,255
C 50,25,50

111111111111111111111111
100000000000000000000001
101110010100101110000001
101100101010101110000001
101110100010101001000001
1000000000W0000000000001
100000000010000000000001
100000000010000000000001
100000000111000000000001
100000001111100000000001
100000000111000000000001
111111111111111111111111