NO textures/tischmid.xpm
SO textures/SH_T.xpm
WE textures/bne.xpm
EA textures/FWINKEL.xpm

F 25,0,0
C 255,180,255

111111111111111111111111
101000100001000100100001
10101011101001010E001001
101010000000000010010001
100010000100001100001001
101010010000000100010001
101110000001000010000011
100000000100111111111111
111111111111111111111111
