NO textures/tischmid.xpm
SO textures/SH_T.xpm
WE textures/bne.xpm
EA textures/FWINKEL.xpm

F 255,0,0
C 255,180,255

111111111111111111111111
11101011101001010E001011
111010000000000010010011
110010000100001100001011
111010010000000100010011
111110000001000010000011
111111111111111111111111
111111111111111111111111
