NO textures/N_logo.xpm
SO textures/m4default.xpm
WE textures/N_logo.xpm
EA textures/N_logo.xpm

F 100,0,255
C 50,25,50

111111111111111111111111
1S1000000000000100000001
101010111010010100000001
101010000000000100000001
100010000000000100000001
101010000000000100000001
101010001111011110000001
101010000001000001000001
101010000001000000100001
101110000001000000000011
100000000001000000001001
111111111111111111111111
