NO textures/gojo.xpm
SO textures/FWINKEL.xpm
WE textures/SH_T.xpm
EA textures/SS.xpm

F 100,0,255
C 50,25,50

111111111111111111111111
101000100001000100100001
101010111010010100001001
101010000000100100100001
100010000100001100001001
101010010000000100010001
101110000001000010000011
1000000001001111111N11
111111111111111111111111
1111111111111111111111111
111111111111111111111111