NO textures/N_logo.xpm
SO textures/N_logo.xpm
WE textures/N_logo.xpm
EA textures/mdomnik.jpeg

F 100,0,255
C 50,25,50

1111111111111
100N000000001
1111111111111
