NO textures/N_logo.xpm
SO textures/N_logo.xpm
WE textures/N_logo.xpm
EA textures/N_logo.xpm



1111111111111
100N000000001
1111111111111
