NO textures/N_logo.xpm
SO textures/N_logo.xpm
WE textures/N_logo.xpm
EA textures/N_logo.xpm

F 100,0,255
C 50,25,50

1111111111111
10000T00X0001
1111111111111
